AUTOR:	FRANCISCO JAVIER FUENTES BARRAGÁN
GRUPO:	C3

EJECUCION:

$make
$./practica2

COMANDOS:

W:  MOVER ADELANTE
A:  MOVER ATRÁS
S:  GIRAR IZQUIERDA
D:  GIRAR DERECHA
N:  ABRIR ALAS
M:  CERRAR ALAS
Z:  DISPARAR
P:  GIRAR R2D2
O:  EJECTAR R2D2
I:  RECOLOCAR R2D2
Y:  ANIMACIÓN GENERAL
R:  AUMENTA ANIMACION GENERAL
T:  DISMINUYE ANIMACION GENERAL
F:  AUMENTA ANIMACION  ALA
G:  DISMINUYE ANIMACION ALA
C:  AUMENTA ANIMACION MOVIMIENTO
V:  DISMINUYE ANIMACION MOVIMIENTO
B:  AUMENTA ANIMACION DISPARO
H:  DISMINUYE ANIMACION DISPARO
U:  AUMENTA ANIMACION ROTACION
J:  DISMINUYE ANIMACION ROTACION
K:  AUMENTA ANIMACION EJECION
L:  DISMINUYE ANIMACION EJECION
7:  MODO SOLIDO
8:  MODO LINEAS
9:  MODO PUNTOS
4:  MODO AJEDREZ
5:  MODO LINEAS Y SOLIDO
